111111011111
100000000001
100000000001
102000020001
100000000001
100000000001
103340000001
105550000001
105550000001
106000034301
100000000001
111111111111